border_size=1
usage=map

Ms^Xm, Ms^Xm, Ms^Xm, Ms^Xm, Ms^Xm, Ms^Xm, Ms^Xm, Ms^Xm, Ms^Xm
Ms^Xm, Gg, Gg, Gg, Gg, Ch, Ch, 2 Kh, Ms^Xm
Ms^Xm, Gg, Gg, Gg, Gg, Gg, Gg, Ch, Ms^Xm
Ms^Xm, Gg, Gg, Gg, Gg, Gg, Gg, Gg^Ve, Ms^Xm
Ms^Xm, Gg, Gg, Gg, Gg, Gg, Gg, Gg, Ms^Xm
Ms^Xm, Gg, Gg, Gg, Gg, Gg, Gg, Gg, Ms^Xm
Ms^Xm, Ch, Ch, Gg, Gg, Gg, Gg, Gg, Ms^Xm
Ms^Xm, 1 Kh, Ch, Gg^Ve, Gg, Gg, Gg, Gg, Ms^Xm
Ms^Xm, Ms^Xm, Ms^Xm, Ms^Xm, Ms^Xm, Ms^Xm, Ms^Xm, Ms^Xm, Ms^Xm
